1 0 0 0 E e 0 p 1 1 1 0 0 K E
p e 0 p 0 1 0 0 E 1 C E 0 0 0
0 p 0 0 1 1 0 p P 0 p e 0 0 0
0 0 1 0 p 1 1 1 e P E p 0 0 E
0 e 0 0 0 1 0 e 0 0 P 0 0 0 1
0 P 0 E p K 0 0 K 0 p 0 0 E 0
P 0 G 0 0 1 E 0 P E 0 0 0 1 0
E 0 0 1 E 0 P 0 1 1 1 1 0 P 0
K 0 P 0 p 0 1 0 0 p 0 1 0 0 E
