E 0 1 0 P 0 e G p 1
1 e p 0 1 e 1 0 0 1
1 0 1 E 1 E 1 p 0 E
0 E P 0 0 p P e 1 K
E 0 0 1 K C 1 P 1 1
0 p 0 E 0 e p 0 0 E
