1 1 0 0 E 0 p 0 0 E e P 0 p 0
0 1 0 0 E 1 1 1 0 1 E p 0 0 0
0 P p p 1 0 1 1 0 1 C E 0 P E
0 p 0 1 E 0 0 1 1 1 1 e E 0 0
0 1 0 1 0 0 0 e P 0 0 P p E 0
0 P 1 1 e 0 1 0 0 e 0 1 0 0 0
0 0 0 1 0 0 1 0 1 E 0 e 0 0 0
e 0 G 0 K P 1 p 0 P 1 1 0 1 1
E 1 1 0 0 0 1 0 0 E 0 0 p 0 0
